00000000000000000000
00000000000000000000
00000000000000000000
00001111111100000000
00001000000111110000
00001000000100010000
00001000000100010000
00001000000100010000
00001000000100010000
00001111231100010000
00001000000000010000
00001000000000010000
00002000000000010000
00003000000000010000
00001111111111110000
00000000000000000000
00000000000000000000
00000000000000000000
00000000000000000000
00000000000000000000
